# 0=livre 1=obstáculo 2=limpo

111111120020111111102020111111102002111111100202111111120200111111120020111
111111120020111111102020111111102002111111100202111111120200111111120020111
111111120020111111102020111111102002111111100202111111120200111111120020111
111111120020111111102020111111102002111111100202111111120200111111120020111
111111120020111111102020111111102002111111100202111111120200111111120020111
111111120020111111102020111111102002111111100202111111120200111111120020111
000000020020000000002020000000002002000000000202000000020200000000020020000
000000020020000000002020000000002002000000000202000000020200000000020020000
000000020020000000002020000000002002000000000202000000020200000000020020000
000000020020000000002020000000002002000000000202000000020200000000020020000
000000020020000000002020000000002002000000000202000000020200000000020020000
111111120020111111102020111111102002111111100202111111120200111111120020111
111111120020111111102020111111102002111111100202111111120200111111120020111
111111120020111111102020111111102002111111100202111111120200111111120020111
111111120020111111102020111111102002111111100202111111120200111111120020111
111111120020111111102020111111102002111111100202111111120200111111120020111
111111120020111111102020111111102002111111100202111111120200111111120020111
111111120020111111102020111111102002111111100202111111120200111111120020111
000000020020000000002020000000002002000000000202000000020200000000020020000
000000020020000000002020000000002002000000000202000000020200000000020020000
000000020020000000002020000000002002000000000202000000020200000000020020000
000000020020000000002020000000002002000000000202000000020200000000020020000
000000020020000000002020000000002002000000000202000000020200000000020020000
111111120020111111102020111111102002111111100202111111120200111111120020111
111111120020111111102020111111102002111111100202111111120200111111120020111
111111120020111111102020111111102002111111100202111111120200111111120020111
111111120020111111102020111111102002111111100202111111120200111111120020111
111111120020111111102020111111102002111111100202111111120200111111120020111
111111120020111111102020111111102002111111100202111111120200111111120020111
111111120020111111102020111111102002111111100202111111120200111111120020111
000000020020000000002020000000002002000000000202000000020200000000020020000
000000020020000000002020000000002002000000000202000000020200000000020020000
000000020020000000002020000000002002000000000202000000020200000000020020000
000000020020000000002020000000002002000000000202000000020200000000020020000
000000020020000000002020000000002002000000000202000000020200000000020020000
111111120020111111102020111111102002111111100202111111120200111111120020111
111111120020111111102020111111102002111111100202111111120200111111120020111
111111120020111111102020111111102002111111100202111111120200111111120020111
111111120020111111102020111111102002111111100202111111120200111111120020111
111111120020111111102020111111102002111111100202111111120200111111120020111
111111120020111111102020111111102002111111100202111111120200111111120020111
111111120020111111102020111111122002111111120202111111120200111111120020111
222202020020220222202020022220222002022220220202002022020200202202020020220
202002020020200202002020020200202002020200200202002020020200202002020020200
202002020020200202002020020200202002020200200202002020020200202002020020200
202002020020200202002020020200202002020200200202002020020200202002020020200
202002020020200202002020020200202002020200200202002020020200202002020020200
111111120020111111102020111111122002111111120202111111120200111111120020111
111111120020111111102020111111122002111111120202111111120200111111120020111
111111120020111111102020111111122002111111120202111111120200111111120020111
111111120020111111102020111111122002111111120202111111120200111111120020111
111111120020111111102020111111122002111111120202111111120200111111120020111
111111120020111111102020111111122002111111120202111111120200111111120020111
111111120020111111102020111111122002111111120202111111120200111111120020111
222202020020220222202020022220222002022220220202002022020200202202020020220
202002020020200202002020020200202002020200200202002020020200202002020020200
202002020020200202002020020200202002020200200202002020020200202002020020200
202002020020200202002020020200202002020200200202002020020200202002020020200
202002020020200202002020020200202002020200200202002020020200202002020020200
111111120020111111102020111111122002111111120202111111120200111111120020111
111111120020111111102020111111122002111111120202111111120200111111120020111
111111120020111111102020111111122002111111120202111111120200111111120020111
111111120020111111102020111111122002111111120202111111120200111111120020111
111111120020111111102020111111122002111111120202111111120200111111120020111
111111120020111111102020111111122002111111120202111111120200111111120020111
111111120020111111102020111111122002111111120202111111120200111111120020111
222202020020220222202020022220222002022220220202002022020200202202020020220
202002020020200202002020020200202002020200200202002020020200202002020020200
202002020020200202002020020200202002020200200202002020020200202002020020200
202002020020200202002020020200202002020200200202002020020200202002020020200
202002020020200202002020020200202002020200200202002020020200202002020020200
111111120020111111102020111111122002111111120202111111120200111111120020111
111111120020111111102020111111122002111111120202111111120200111111120020111
111111120020111111102020111111122002111111120202111111120200111111120020111
111111120020111111102020111111122002111111120202111111120200111111120020111
111111120020111111102020111111122002111111120202111111120200111111120020111
111111120020111111102020111111122002111111120202111111120200111111120020111
111111120020111111102020111111122002111111120202111111120200111111120020111
222202020020220222202020022220222002022220220202002022020200202202020020220
202002020020200202002020020200202002020200200202002020020200202002020020200
202002020020200202002020020200202002020200200202002020020200202002020020200
202002020020200202002020020200202002020200200202002020020200202002020020200
202002020020200202002020020200202002020200200202002020020200202002020020200
111111120020111111102020111111122002111111120202111111120200111111120020111
111111120020111111102020111111122002111111120202111111120200111111120020111
111111120020111111102020111111122002111111120202111111120200111111120020111
111111120020111111102020111111122002111111120202111111120200111111120020111
111111120020111111102020111111122002111111120202111111120200111111120020111
111111120020111111102020111111122002111111120202111111120200111111120020111
111111120020111111102020111111122002111111120202111111120200111111120020111
222202020020220222202020022220222002022220220202002022020200202202020020220
202002020020200202002020020200202002020200200202002020020200202002020020200
202002020020200202002020020200202002020200200202002020020200202002020020200
202002020020200202002020020200202002020200200202002020020200202002020020200
202002020020200202002020020200202002020200200202002020020200202002020020200
111111120020111111102020111111122002111111120202111111120200111111120020111
111111120020111111102020111111122002111111120202111111120200111111120020111
111111120020111111102020111111122002111111120202111111120200111111120020111
111111120020111111102020111111122002111111120202111111120200111111120020111
111111120020111111102020111111122002111111120202111111120200111111120020111
111111120020111111102020111111122002111111120202111111120200111111120020111
111111120020111111102020111111122002111111120202111111120200111111120020111
222202020020220222202020022220222002022220220202002022020200202202020020220
202002020020200202002020020200202002020200200202002020020200202002020020200
202002020020200202002020020200202002020200200202002020020200202002020020200
202002020020200202002020020200202002020200200202002020020200202002020020200
202002020020200202002020020200202002020200200202002020020200202002020020200
111111120020111111102020111111122002111111120202111111120200111111120020111
111111120020111111102020111111122002111111120202111111120200111111120020111
111111120020111111102020111111122002111111120202111111120200111111120020111
111111120020111111102020111111122002111111120202111111120200111111120020111
111111120020111111102020111111122002111111120202111111120200111111120020111
111111120020111111102020111111122002111111120202111111120200111111120020111
111111120020111111102020111111122002111111120202111111120200111111120020111
222202020020220222202020022220222002022220220202002022020200202202020020220
202002020020200202002020020200202002020200200202002020020200202002020020200
202002020020200202002020020200202002020200200202002020020200202002020020200
202002020020200202002020020200202002020200200202002020020200202002020020200
202002020020200202002020020200202002020200200202002020020200202002020020200
111111120020111111102020111111122002111111120202111111120200111111120020111
111111120020111111102020111111122002111111120202111111120200111111120020111
111111120020111111102020111111122002111111120202111111120200111111120020111
111111120020111111102020111111122002111111120202111111120200111111120020111
111111120020111111102020111111122002111111120202111111120200111111120020111
111111120020111111102020111111122002111111120202111111120200111111120020111
111111120020111111102020111111122002111111120202111111120200111111120020111
222202020020220222202020022220222002022220220202002022020200202202020020220
202002020020200202002020020200202002020200200202002020020200202002020020200
202002020020200202002020020200202002020200200202002020020200202002020020200
202002020020200202002020020200202002020200200202002020020200202002020020200
202002020020200202002020020200202002020200200202002020020200202002020020200
111111120020111111102020111111122002111111120202111111120200111111120020111
111111120020111111102020111111122002111111120202111111120200111111120020111
111111120020111111102020111111122002111111120202111111120200111111120020111
111111120020111111102020111111122002111111120202111111120200111111120020111
111111120020111111102020111111122002111111120202111111120200111111120020111
111111120020111111102020111111122002111111120202111111120200111111120020111
111111100000111111100000111111100000111111100000111111100000111111100000111
222202020020220222202020022220222002022220220202002022020200202202020020220
202002020020200202002020020200202002020200200202002020020200202002020020200
202002020020200202002020020200202002020200200202002020020200202002020020200
202002020020200202002020020200202002020200200202002020020200202002020020200
202002020020200202002020020200202002020200200202002020020200202002020020200
111111120020111111102020111111122002111111120202111111120200111111120020111
111111120020111111102020111111122002111111120202111111120200111111120020111
111111120020111111102020111111122002111111120202111111120200111111120020111
111111120020111111102020111111122002111111120202111111120200111111120020111
111111120020111111102020111111122002111111120202111111120200111111120020111
111111120020111111102020111111122002111111120202111111120200111111120020111
111111100000111111100000111111120000111111120000111111100000111111100000111
